NO	./Textures/NO.xpm
  
					      
  SO			./Textures/SO.xpm
  
	    EA				./Textures/EA.xpm
                       
					WE         ./Textures/WE.xpm

F	245,168,232

		C 0,59,30








											  111111111111111111111111111
1111111111111111111111111111111111111111111111101111111111101111111111111
1001001001001000000000000000000000000000000000000000000000000000000000001
100000000000000000000S001001111111111111111111111111111111111111111111111
1001000001001000000000000001
1111100010000000000000000001
	110110000000000000000001                 
    100010000000000000000001                 
    100011111111111111111111                 
    10001                 
    11111                  

