111111111111111111111111111111
111111110000000000000000000001
111E0000000N1111010N0011011001
111000N0011111111101001N0N1001
111C00001111C0000N01N01NCN10N1
11111111111101101101001NNN1001
111111111111N10001010011111001
100000000000000P000000100C0001
10110N01100101000101N011111001
10110N0110010110110100111110N1
1N000C000001000000C10N11111001
10110N011001011111110011111001
10110N0110000100000N0011111N01
1C0000000000C100N0C00000000001
111111111111111111111111111111
