11111111
1P1C00E1
10101001
100000C1
11111111
